%s used of %s %s %%=%s used of %s (%s %%)
---=
Active tunnels=Tunnel Attivi
Activity=Attività
ago=fa
Airflow=Flusso d'aria
All Apps=Tutte le Apps
All VMs= Tutte le VMs
Battery charge=Carica Batteria
BIOS dated=BIOS datato
Click to toggle details= Click per i dettagli
Completed=Completato
Counters info=Info Contatori
Current operation %s on %s=Operazione corrente %s su **%s**
custom image= immagine personalizzata
Data is invalid= La data non è valida
default image= imagine di default
Docker Containers=Container Docker
Due in=Tempo stimato
Elapsed time=Tempo trascorso
Errors info=Info errori
Estimated finish=Fine stimata
failed device=dispositivo guasto
Fan count=Numero ventole
FAN=Ventola
Finding %s error=Ricerca: **%s** errore
Finding %s errors=Ricerca: **%s** errori
General info=Informazioni generali
Go to cache settings=Vai alle impostazioni della cache
Go to CPU pinning settings=Vai alle impostazioni CPU pinning
Go to disk settings=Vai alle impostazioni del disco
Go to Docker settings=Vai alle impostazioni di Docker
Go to fan settings=Vai alle impostazioni delle ventole
Go to identification settings=Vai alle impostazioni di identificazione
Go to network settings=Vai alle impostazioni di rete
Go to scheduler settings=Vai alle impostazioni di pianificazione
Go to Share settings=Vai alle impostazioni delle Cartelle Condivise
Go to UPS settings=Vai alle impostazioni del gruppo di continuità
Go to User settings=Vai alle impostazioni Utente
Go to VM settings=Vai alle impostazioni delle VM
Go to VPN settings=Vai alle impostazioni della VPN
Handshake= Handshake
has= ha
healthy=in buona salute
heat warning=avvertenza calore__surriscaldamento
Hide details=Nascondi dettagli
in progress=in corso
Inactive tunnels=Tunnel inattivi
inactive=Non attivo
Inbound=In entrata
invalid device=Dispositivo non valido
invalid devices=Dispositivi non validi
Last check completed on %s=Ultimo controllo completato il %s
Last check incomplete on %s=Ultimo controllo incompleto il %s
Last checked on %s=Controllato l'ultima volta il %s
Maximum size=Dimensioni massime
Mode of operation=Modalità operativa
Next check scheduled on %s=Prossimo check pianificato il %s
No docker containers defined=Nessun container Docker definito
No running docker containers=Nessun container Docker in esecuzione
No running virtual machines=Nessuna macchina virtuale in esecuzione
No shares present=Nessuna cartella condivisa presente
No virtual machines defined=Nessuna macchina virtuale definita
Nominal power=Potenza nominale
not received=non ricevuto
Outbound=In uscita
Overall Load=Carico Complessivo
Parity disk not present=Disco di parità assente
Parity disks not present=Dischi di parità assenti
Parity has not been checked yet=La parità non è ancora stata verificata
Parity is degraded=La parità è compromessa
Power= Potenza
Put system to sleep=Metti il sistema in sospensioneRiposo
Reboot the system=Riavvia il sistema
Receive counters=Contatori di ricezione
Received packets=Pacchetti ricevuti
Runtime left=Autonomia rimanente
Scheduled parity check is disabled=Il controllo di parità pianificato è disabilitato
Select Case Model=Seleziona modello case
Share count %s with %s cache only and %s encrypted=Numero di cartelle condivise %s di cui %s solo cache e %s cifrate
Show details=Mostra dettagli
Show Information=Mostra informazioni
Shutdown the system=Arresta il sistema
SMART error=Errore SMART
SMART=SMART
sn=sn
Start the array=Avvia l'array
Started only=Solo avviato
Stop the array=Arresta l'array
This will put the system to sleep=Questo metterà il sistema a riposoSospensione
This will reboot the system=Questo riavvierà il sistema
This will shutdown the system=Questo arresterà il sistema
This will start the array=Questo avvierà l'array
This will stop the array=Questo arresterà l'array
Transmit counters=Contatori di trasmissioni
Transmitted packets=Pacchetti trasmessi
UPS Load=Carico UPS
UPS status=Stato UPS
Usable size=Capacità utilizzabile
User count %s with %s unprotected=Numero utenti %s di cui %s non protetti
utilization warning=avviso di utilizzo
View Running Processes=Visualizza Processi In Esecuzione
Virtual Machines=Macchine Virtuali

; New entries - 2021-03-14
Temp=Temp
