%s An update is available=%s: un aggiornamento Ã¨ disponibile.
anonymous= anonimo
Author= autore
Check For Updates= controllo per aggiornamenti
Click here to install version %s= click qui per installare nuova versione
DOWNGRADE TO VERSION= retrocedere alla versione
Enter URL of remote plugin file or local plugin file= inserire l'URL repository remoto del plugin o il percorso file locale del plugin
ERROR= ERRORE
Install Plugin=Installa plugin
Install=Installa
install=installa
Installed Plugins=Plugin installati
Installing Update=Installazione aggiornamenti
need check=controllo Richiesto_need check
Next=prossimo
No release notes available=Nessuna nota di rilascio disponibile
Plugin File=Plugin File
Plugin Update Check=_Controllo Aggiornamento Plugin Update Check
Plugin=Plugin
Release Notes=Note di rilascio
remove=Rimuovi
Select local plugin file=Selezionare file locali plugin_Select local plugin file
Stable=Stabile
STALE=STALE_ vecchio stantio
Support Thread=Thread di supporto
Uninstall=disinstalla
Update All Plugins=Aggorna Tutti I Plugin
Upgrade=Upgrade_aggiorna
View Release Notes=vedi note di rilascio

; New entries - 2021-03-14
No plugins installed=Nessun Plugin installato
