Add Share= Aggiungi condivisione_Share
All files encrypted=Tutti i file sono Crittografati
All files protected=tutti i file sono protetti
All files unprotected=tutti i file non sono protetti
Allocation method=metodo di allocazione
Array must be Started to view Shares=Array must be **Started** to view Shares
Automatically split any directory as required=atutomatico divisione di qualsiasi cartella se richiesto
Automatically split only the top five directory levels as required=atutomatico divisione soltanto la the top five directory levels as required
Automatically split only the top four directory levels as required=atutomatico divisione soltanto
Automatically split only the top level directory as required=atutomatico divisione soltanto
Automatically split only the top three directory levels as required=atutomatico divisione soltanto
Automatically split only the top two directory levels as required=atutomatico divisione soltanto
Comments=commenti
Compute All=Calcola tutto
Compute=Calcola
Disk Shares=Condivisione Disco
Do not use reserved names=Non usare nomi riservati
Do not use pool names=Non usare nomi  pool
Enable Copy-on-write= abilita Copy-on-write
Enter a name for the share=inserire un nome per la condivisione_Share
Excluded disks=dischi esclusi
Export=esporta
Fill-up=fill-up
Free=liberi
has been deleted=è stato cancellato
HDD=HDD
High-water=High-water
Included disks=dischi inclusi
Invalid Characters=caratteri non validi
Invalid share name=nome cartella non valida
Manual do not automatically split directories=Manuale: non dividere automaticamente le cartelle
Minimum free space=minimo spazio libero
Missing share name=nome share mancante
Most-free=Most-free
Mover takes no action=Mover takes no action
Mover transfers files from array to cache=Mover transferirà i file dall'array alla cache
Mover transfers files from cache to array=Mover transferirà i file dalla cache all'array
next user share=prossima user share
Only=solo
Prefer=preferito
previous user share=precedente user share
Read=leggi
Recompute=ricalcola
Rule=regola
Select cache pool=selezionare cache pool
Set when adding new share only=Set when adding new share only
Share contains data=la share contiene dati
Share is empty=la cartella è vuota share
Share is outside the list of designated disks=la share è fuori dall lista dei dischi designati_Share is outside the list of designated disks
Share Settings=impostazioni share
Share status=stato share
Size=dimensioni
Some or all files unencrypted=alcuni o tutti i file non sono crittografati
Some or all files unprotected=alcuni o tutti i file non sono protetti
Split level=split level_dividi livelli
SSD=SSD
There are no exportable disk shares=non ci sono disk share esportabili
There are no exportable user shares=non ci sono condivisioni utente esportabili
Time Machine volume size limit=limiti volume Time Machine
Unknown encryption state=stato crittografico sconosiuto 
Use cache pool for new filesdirectories=Use cache pool (for new files/directories)
User Shares=User Shares
Volume dbpath=Volume dbpath
Write=Scrivi
You cannot use the following within share names=non è possibile usare i seguenti nomi nella share
