20 EHCI=2.0 (EHCI)
30 nec XHCI=3.0 (nec XHCI)
30 qemu XHCI=3.0 (qemu XHCI)
Allocation=Allocazione
and if using graphics device passthrough it too needs UEFI=e se viene usato un dispositivo grafico da passare alla VM è necessiario UEFI
Are you sure=Si è certi
Array must be started to view Virtual Machines=Array deve esssere **AVVIATO** per visualizare le macchine virtuali
Autostart=avvio automatico
Back=Indietro
Bus=Bus
Capacity=Capacità
Change Icon=Cambia icona
Cleanup=Pulizia_cleanup
Click and Select cdrom image to install operating system=click e selezione dell'immagine cdrom per installare il sistema operativo
Config Folder=cartella di configurazione_Config folder
Copy Paste Domain XML Configuration Here=Copy &amp; Paste Domain XML Configuration Here_copia &amp; incolla Dominio XML Configurazione qui
CPU Mode=Modalità CPU
CPUs=CPUs
Create=Crea
Creating=creazione in corso_ Creating
define the amount memory=definire la quantita di memoria
define the maximum amount of memory=definire la massima quantita di memoria
define type of cpu presented to this vm=definire la tipologia di cpu presentata alla VM
description of virtual machine=descrizione della macchina virtuale
Disk devices=dispositivi disco
Download Folder=cartella download
Download, Click and Select virtio drivers image=Scarire , click e selezione dell'immagine driver virtio
Downloading=download in corso
eg=e.g._esempio
Emulated=Emulazione
Extracting=Estrazione in corso_ Extracting
Folder to save the LibreELEC image to=Cartella per salvare l'immagine LibreELEC ->
Folder to save the OpenELEC image to=Cartella per salvare l'immagine OpenELEC ->
Form View=vista modulo_form View
free=libero/i _free
Graphics Card=Scheda grafica
Graphics ROM BIOS=ROM BIOS Grafico
Graphics=Grafica
Host Passthrough=Host Passthrough
Hyperv tweaks for Windows=Hyperv, Aggustameti per windows
Hyper-V=Hyper-V
i440fx will work for most=i440fx funzionerà per la maggior parte_will work for most
Icon=icona
Initial=Initial_iniziale
Invalid VM to edit=Invalida VM da modificare
ISO storage path doesnt exist=ISO storage path doesn't exist_il percorso di archiviazione dellimmagine ISO non esiste
ISO storage path was empty=il percorso di archiviazione delle immagini ISO era vuoto
keyboard for VNC=Tastiera per VNC
LibreELEC Version=Versione LibreELEC
LibreELEC=LibreELEC
Libvirt Service failed to start=Avvio fallito sevizio Libvirt 
Logical CPUs=CPU logiche
Machine=Macchina(cipset)_ Macchine
Manual=Manuale
Max=Max
MD5 verification failed, your download is incomplete or corrupted=Verifica hash MD5 fallita, il download è incompleto o corrotto
mount tag inside vm=mount tag inside vm_
My Workstation=la mia Workstation
name of mount tag inside vm=name of mount tag inside vm
Name of virtual machine=Nome della Macchina Virtuale
Network Bridge=Network Bridge
Network MAC=Network MAC
Network Model=Network Model
No Virtual Machines installed=Non ci sono Macchine Virtuali Installate
None available=None available_nessuno disponibile
Not enough free space, need at least=Spazio libero insufficiente, è necessiario almeno
Not running=Not running_ fermo
OpenELEC Version=Versione OpenELEC
OpenELEC=OpenELEC
OS Install CDRom Bus=
OS Install ISO=ISO di installzione OS
Other PCI Devices=Altre dispositivi PCI
OVMF requires a UEFI-compatable OS=OVMF richiede un Sistema operativo co
OVMF=OVMF
password for VNC=Password per VNC
path of Unraid share=percorso di Unraid share
path on Unraid share to save LibreELEC settings=percorso di Unraid share persalvare le impostazioni di LibreELEC
path on Unraid share to save OpenELEC settings=percorso di Unraid share persalvare le impostazioni di OpenELEC
Path to ROM BIOS file=percorso del file ROM BIOS
Please choose a folder the LibreELEC image will download to=perfavore scegliere una cartella dove scaricare LibreELEC
Please choose a folder the OpenELEC image will download to=perfavore scegliere una cartella dove scaricare OpenELEC
Primary=Primario
Q35 for a newer machine model with PCIE=Q35 per una nuovo modello macchina con PCIE_Q35 for a newer machine model with PCIE
QEMU64=QEMU64
random mac, you can supply your own=mac casuale, è possibile fornirne uno proprio
re-generate random mac address=rigenera indirizzo mac casuale
Remove LibreELEC image=Rimuovere immagine LibreELEC_Remove LibreELEC image
Remove OpenELEC image=Rimuovere immagine OpenELEC_Remove OpenELEC image
Remove this LibreELEC file=rimuovere questo LibreELEC file
Remove this OpenELEC file=rimuovere questo OpenELEC file
SeaBIOS will work for most=SeaBIOS funzionerà per la maggior parte_will work for most
SeaBIOS=SeaBIOS
Select the BIOS=Selezionare il bios
Select the LibreELEC version to use=selezionare la verisione da usare di LibreELEC
Select the machine model=Selezionare il modello macchina
Select the OpenELEC version to use=selezionare la verisione da usare di OpenELEC
Select the USB Controller to emulate=Selezionare il controller USB da Emulare
Separate sub-folder and image will be created based on Name=Verranno create sottocartelle e immagini separate in base al Nome
shares=Shares
Some OSes wont support USB3=Some OSes won't support USB3_Alcuni SO non supportano USB3
Sound Card=Scheda Audio
Start All=Avvia tutte
Start VM after creation=Avvio macchina virtuale Dopo la creazione
Stop All=Ferma tutto
Toggle VM autostart=Interruttore_toggle avvio automatico VM
type of storage image=tipo di immagine di storage
Unknown action=Azione Sconosciuta
Unknown version=Versione sconosciuta
Unraid Mount tag=Unraid Mount tag
Unraid Share=Unraid Share
Updating=Aggiornamento in corso
USB Controller=Controller USB
USB Devices=Dispositivi USB
vDisk Bus=Bus disco virtuale
vDisk Location=percorso disco virtuale
vDisk Size=dimensione disco virtuale
vDisk Type=tipo disco virtuale
vDisks=disco virtuale
video for VNC=video per_for VNC
VirtIO Drivers CDRom Bus=VirtIO drivers cdrom bus
VirtIO Drivers ISO=ISO driver VirtIO
Virtual Machines=Macchine Virtuali
VM creation error=Errore creazione VM
VM image deletion error=Errore cancellazione Immagine VM
VNC Keyboard=Tastiera VNC (lingua)
VNC Password=VNC Password
VNC Video Driver=VNC Driver Video
VNC=VNC
Wasnt able to stop the process=Non è stato possibile fermare il processo
Windows 7XP=Windows 7/XP
Windows 82012, newer Linux distros=Windows 8/2012, nuove distribizioni Linux
XML View=vista XML
